Lactobacillus apinorum	Apilactobacillus apinorum	Apilactobacillus
Lactobacillus bombintestini	Apilactobacillus bombintestini	Apilactobacillus
Lactobacillus kunkeei	Apilactobacillus kunkeei	Apilactobacillus
Lactobacillus micheneri	Apilactobacillus micheneri	Apilactobacillus
Lactobacillus ozensis	Apilactobacillus ozensis	Apilactobacillus
Lactobacillus quenuiae	Apilactobacillus quenuiae	Apilactobacillus
Lactobacillus timberlakei	Apilactobacillus timberlakei	Apilactobacillus
Lactobacillus acetotolerans	Lactobacillus acetotolerans	Lactobacillus
Lactobacillus acidophilus	Lactobacillus acidophilus	Lactobacillus
Lactobacillus amylolyticus	Lactobacillus amylolyticus	Lactobacillus
Lactobacillus amylovorus	Lactobacillus amylovorus	Lactobacillus
Lactobacillus apis	Lactobacillus apis	Lactobacillus
Lactobacillus bombicola	Lactobacillus bombicola	Lactobacillus
Lactobacillus colini	Lactobacillus colini	Lactobacillus
Lactobacillus crispatus	Lactobacillus crispatus	Lactobacillus
Lactobacillus delbrueckii subsp. bulgaricus	Lactobacillus delbrueckii subsp. bulgaricus	Lactobacillus
Lactobacillus delbrueckii subsp. delbrueckii	Lactobacillus delbrueckii subsp. delbrueckii	Lactobacillus
Lactobacillus delbrueckii subsp. indicus	Lactobacillus delbrueckii subsp. indicus	Lactobacillus
Lactobacillus delbrueckii subsp. jakobsenii	Lactobacillus delbrueckii subsp. jakobsenii	Lactobacillus
Lactobacillus delbrueckii subsp. lactis	Lactobacillus delbrueckii subsp. lactis	Lactobacillus
Lactobacillus delbrueckii subsp. sunkii	Lactobacillus delbrueckii subsp. sunkii	Lactobacillus
Lactobacillus equicursoris	Lactobacillus equicursoris	Lactobacillus
Lactobacillus fornicalis	Lactobacillus fornicalis	Lactobacillus
Lactobacillus gallinarum	Lactobacillus gallinarum	Lactobacillus
Lactobacillus gasseri	Lactobacillus gasseri	Lactobacillus
Lactobacillus gigeriorum	Lactobacillus gigeriorum	Lactobacillus
Lactobacillus hamsteri	Lactobacillus hamsteri	Lactobacillus
Lactobacillus helsingborgensis	Lactobacillus helsingborgensis	Lactobacillus
Lactobacillus helveticus	Lactobacillus helveticus	Lactobacillus
Lactobacillus hominis	Lactobacillus hominis	Lactobacillus
Lactobacillus iners	Lactobacillus iners	Lactobacillus
Lactobacillus intestinalis	Lactobacillus intestinalis	Lactobacillus
Lactobacillus jensenii	Lactobacillus jensenii	Lactobacillus
Lactobacillus johnsonii	Lactobacillus johnsonii	Lactobacillus
Lactobacillus kalixensis	Lactobacillus kalixensis	Lactobacillus
Lactobacillus kefiranofaciens subsp. kefiranofaciens	Lactobacillus kefiranofaciens subsp. kefiranofaciens	Lactobacillus
Lactobacillus kefiranofaciens subsp. kefirgranum	Lactobacillus kefiranofaciens subsp. kefirgranum	Lactobacillus
Lactobacillus kimbladii	Lactobacillus kimbladii	Lactobacillus
Lactobacillus kitasatonis	Lactobacillus kitasatonis	Lactobacillus
Lactobacillus kullabergensis	Lactobacillus kullabergensis	Lactobacillus
Lactobacillus melliventris	Lactobacillus melliventris	Lactobacillus
Lactobacillus mulieris	Lactobacillus mulieris	Lactobacillus
Lactobacillus panisapium	Lactobacillus panisapium	Lactobacillus
Lactobacillus paragasseri	Lactobacillus paragasseri	Lactobacillus
Lactobacillus pasteurii	Lactobacillus pasteurii	Lactobacillus
Lactobacillus porci	Lactobacillus porci	Lactobacillus
Lactobacillus psittaci	Lactobacillus psittaci	Lactobacillus
Lactobacillus rodentium	Lactobacillus rodentium	Lactobacillus
Lactobacillus taiwanensis	Lactobacillus taiwanensis	Lactobacillus
Lactobacillus ultunensis	Lactobacillus ultunensis	Lactobacillus
Lactobacillus xujianguonis	Lactobacillus xujianguonis	Lactobacillus
Lactobacillus amylophilus	Amylolactobacillus amylophilus	Amylolactobacillus
Lactobacillus amylotrophicus	Amylolactobacillus amylotrophicus	Amylolactobacillus
Lactobacillus floricola	Holzapfelia floricola	Holzapfelia
Lactobacillus bombi	Bombilactobacillus bombi	Bombilactobacillus
Lactobacillus mellifer	Bombilactobacillus mellifer	Bombilactobacillus
Lactobacillus mellis	Bombilactobacillus mellis	Bombilactobacillus
Lactobacillus alimentarius	Companilactobacillus alimentarius	Companilactobacillus
Lactobacillus allii	Companilactobacillus allii	Companilactobacillus
Lactobacillus baiquanensis	Companilactobacillus baiquanensis	Companilactobacillus
Lactobacillus bobalius	Companilactobacillus bobalius	Companilactobacillus
Lactobacillus crustorum	Companilactobacillus crustorum	Companilactobacillus
Lactobacillus farciminis	Companilactobacillus farciminis	Companilactobacillus
Lactobacillus formosensis	Companilactobacillus formosensis	Companilactobacillus
Lactobacillus furfuricola	Companilactobacillus furfuricola	Companilactobacillus
Lactobacillus futsaii	Companilactobacillus futsaii	Companilactobacillus
Lactobacillus ginsenosidimutans	Companilactobacillus ginsenosidimutans	Companilactobacillus
Lactobacillus halodurans	Companilactobacillus halodurans	Companilactobacillus
Lactobacillus heilongjiangensis	Companilactobacillus heilongjiangensis	Companilactobacillus
Lactobacillus huachuanensis	Companilactobacillus huachuanensis	Companilactobacillus
Lactobacillus hulinensis	Companilactobacillus hulinensis	Companilactobacillus
Lactobacillus insicii	Companilactobacillus insicii	Companilactobacillus
Lactobacillus jidongensis	Companilactobacillus jidongensis	Companilactobacillus
Lactobacillus kedongensis	Companilactobacillus kedongensis	Companilactobacillus
Lactobacillus keshanensis	Companilactobacillus keshanensis	Companilactobacillus
Lactobacillus kimchiensis	Companilactobacillus kimchiensis	Companilactobacillus
Lactobacillus kimchii	Companilactobacillus kimchii	Companilactobacillus
Lactobacillus metriopterae	Companilactobacillus metriopterae	Companilactobacillus
Lactobacillus mindensis	Companilactobacillus mindensis	Companilactobacillus
Lactobacillus mishanensis	Companilactobacillus mishanensis	Companilactobacillus
Lactobacillus musae	Companilactobacillus musae	Companilactobacillus
Lactobacillus nantensis	Companilactobacillus nantensis	Companilactobacillus
Lactobacillus nodensis	Companilactobacillus nodensis	Companilactobacillus
Lactobacillus nuruki	Companilactobacillus nuruki	Companilactobacillus
Lactobacillus paralimentarius	Companilactobacillus paralimentarius	Companilactobacillus
Lactobacillus salsicarnum	Companilactobacillus salsicarnum	Companilactobacillus
Lactobacillus suantsaicola	Companilactobacillus suantsaicola	Companilactobacillus
Lactobacillus tucceti	Companilactobacillus tucceti	Companilactobacillus
Lactobacillus versmoldensis	Companilactobacillus versmoldensis	Companilactobacillus
Lactobacillus zhachilii	Companilactobacillus zhachilii	Companilactobacillus
Lactobacillus zhongbaensis	Companilactobacillus zhongbaensis	Companilactobacillus
Lactobacillus achengensis	Lapidilactobacillus achengensis	Lapidilactobacillus
Lactobacillus bayanensis	Lapidilactobacillus bayanensis	Lapidilactobacillus
Lactobacillus concavus	Lapidilactobacillus concavus	Lapidilactobacillus
Lactobacillus dextrinicus	Lapidilactobacillus dextrinicus	Lapidilactobacillus
Lactobacillus gannanensis	Lapidilactobacillus gannanensis	Lapidilactobacillus
Lactobacillus mulanensis	Lapidilactobacillus mulanensis	Lapidilactobacillus
Lactobacillus wuchangensis	Lapidilactobacillus wuchangensis	Lapidilactobacillus
Lactobacillus composti	Agrilactobacillus composti	Agrilactobacillus
Lactobacillus yilanensis	Agrilactobacillus yilanensis	Agrilactobacillus
Lactobacillus harbinensis	Schleiferilactobacillus harbinensis	Schleiferilactobacillus
Lactobacillus perolens	Schleiferilactobacillus perolens	Schleiferilactobacillus
Lactobacillus shenzhenensis	Schleiferilactobacillus shenzhenensis	Schleiferilactobacillus
Lactobacillus baoqingensis	Lacticaseibacillus baoqingensis	Lacticaseibacillus
Lactobacillus brantae	Lacticaseibacillus brantae	Lacticaseibacillus
Lactobacillus camelliae	Lacticaseibacillus camelliae	Lacticaseibacillus
Lactobacillus casei	Lacticaseibacillus casei	Lacticaseibacillus
Lactobacillus chiayiensis	Lacticaseibacillus chiayiensis	Lacticaseibacillus
Lactobacillus daqingensis	Lacticaseibacillus daqingensis	Lacticaseibacillus
Lactobacillus hegangensis	Lacticaseibacillus hegangensis	Lacticaseibacillus
Lactobacillus hulanensis	Lacticaseibacillus hulanensis	Lacticaseibacillus
Lactobacillus jixianensis	Lacticaseibacillus jixianensis	Lacticaseibacillus
Lactobacillus manihotivorans	Lacticaseibacillus manihotivorans	Lacticaseibacillus
Lactobacillus nasuensis	Lacticaseibacillus nasuensis	Lacticaseibacillus
Lactobacillus pantheris	Lacticaseibacillus pantheris	Lacticaseibacillus
Lactobacillus paracasei subsp. paracasei	Lacticaseibacillus paracasei subsp. paracasei	Lacticaseibacillus
Lactobacillus paracasei subsp. tolerans	Lacticaseibacillus paracasei subsp. tolerans	Lacticaseibacillus
Lactobacillus porcinae	Lacticaseibacillus porcinae	Lacticaseibacillus
Lactobacillus rhamnosus	Lacticaseibacillus rhamnosus	Lacticaseibacillus
Lactobacillus saniviri	Lacticaseibacillus saniviri	Lacticaseibacillus
Lactobacillus sharpeae	Lacticaseibacillus sharpeae	Lacticaseibacillus
Lactobacillus songhuajiangensis	Lacticaseibacillus songhuajiangensis	Lacticaseibacillus
Lactobacillus suibinensis	Lacticaseibacillus suibinensis	Lacticaseibacillus
Lactobacillus thailandensis	Lacticaseibacillus thailandensis	Lacticaseibacillus
Lactobacillus yichunensis	Lacticaseibacillus yichunensis	Lacticaseibacillus
Lactobacillus zhaodongensis	Lacticaseibacillus zhaodongensis	Lacticaseibacillus
Lactobacillus selangorensis	Paralactobacillus selangorensis	Paralactobacillus
Lactobacillus curvatus	Latilactobacillus curvatus	Latilactobacillus
Lactobacillus fuchuensis	Latilactobacillus fuchuensis	Latilactobacillus
Lactobacillus graminis	Latilactobacillus graminis	Latilactobacillus
Lactobacillus sakei subsp. carnosus	Latilactobacillus sakei subsp. carnosus	Latilactobacillus
Lactobacillus sakei subsp. sakei	Latilactobacillus sakei subsp. sakei	Latilactobacillus
Lactobacillus backii	Loigolactobacillus backii	Loigolactobacillus
Lactobacillus bifermentans	Loigolactobacillus bifermentans	Loigolactobacillus
Lactobacillus binensis	Loigolactobacillus binensis	Loigolactobacillus
Lactobacillus coryniformis subsp. coryniformis	Loigolactobacillus coryniformis subsp. coryniformis	Loigolactobacillus
Lactobacillus coryniformis subsp. torquens	Loigolactobacillus coryniformis subsp. torquens	Loigolactobacillus
Lactobacillus iwatensis	Loigolactobacillus iwatensis	Loigolactobacillus
Lactobacillus jiayinensis	Loigolactobacillus jiayinensis	Loigolactobacillus
Lactobacillus rennini	Loigolactobacillus rennini	Loigolactobacillus
Lactobacillus zhaoyuanensis	Loigolactobacillus zhaoyuanensis	Loigolactobacillus
Lactobacillus algidus	Dellaglioa algidus	Dellaglioa
Lactobacillus aquaticus	Liquorilactobacillus aquaticus	Liquorilactobacillus
Lactobacillus cacaonum	Liquorilactobacillus cacaonum	Liquorilactobacillus
Lactobacillus capillatus	Liquorilactobacillus capillatus	Liquorilactobacillus
Lactobacillus ghanensis	Liquorilactobacillus ghanensis	Liquorilactobacillus
Lactobacillus hordei	Liquorilactobacillus hordei	Liquorilactobacillus
Lactobacillus mali	Liquorilactobacillus mali	Liquorilactobacillus
Lactobacillus nagelii	Liquorilactobacillus nagelii	Liquorilactobacillus
Lactobacillus oeni	Liquorilactobacillus oeni	Liquorilactobacillus
Lactobacillus satsumensis	Liquorilactobacillus satsumensis	Liquorilactobacillus
Lactobacillus sicerae	Liquorilactobacillus sicerae	Liquorilactobacillus
Lactobacillus sucicola	Liquorilactobacillus sucicola	Liquorilactobacillus
Lactobacillus uvarum	Liquorilactobacillus uvarum	Liquorilactobacillus
Lactobacillus vini	Liquorilactobacillus vini	Liquorilactobacillus
Lactobacillus acidipiscis	Ligilactobacillus acidipiscis	Ligilactobacillus
Lactobacillus agilis	Ligilactobacillus agilis	Ligilactobacillus
Lactobacillus animalis	Ligilactobacillus animalis	Ligilactobacillus
Lactobacillus apodemi	Ligilactobacillus apodemi	Ligilactobacillus
Lactobacillus araffinosus	Ligilactobacillus araffinosus	Ligilactobacillus
Lactobacillus aviarius	Ligilactobacillus aviarius	Ligilactobacillus
Lactobacillus ceti	Ligilactobacillus ceti	Ligilactobacillus
Lactobacillus equi	Ligilactobacillus equi	Ligilactobacillus
Lactobacillus faecis	Ligilactobacillus faecis	Ligilactobacillus
Lactobacillus hayakitensis	Ligilactobacillus hayakitensis	Ligilactobacillus
Lactobacillus murinus	Ligilactobacillus murinus	Ligilactobacillus
Lactobacillus pobuzihii	Ligilactobacillus pobuzihii	Ligilactobacillus
Lactobacillus ruminis	Ligilactobacillus ruminis	Ligilactobacillus
Lactobacillus saerimneri	Ligilactobacillus saerimneri	Ligilactobacillus
Lactobacillus salitolerans	Ligilactobacillus salitolerans	Ligilactobacillus
Lactobacillus salivarius	Ligilactobacillus salivarius	Ligilactobacillus
Lactobacillus daoliensis	Lactiplantibacillus daoliensis	Lactiplantibacillus
Lactobacillus daowaiensis	Lactiplantibacillus daowaiensis	Lactiplantibacillus
Lactobacillus dongliensis	Lactiplantibacillus dongliensis	Lactiplantibacillus
Lactobacillus fabifermentans	Lactiplantibacillus fabifermentans	Lactiplantibacillus
Lactobacillus garii	Lactiplantibacillus garii	Lactiplantibacillus
Lactobacillus herbarum	Lactiplantibacillus herbarum	Lactiplantibacillus
Lactobacillus modestisalitolerans	Lactiplantibacillus modestisalitolerans	Lactiplantibacillus
Lactobacillus mudanjiangensis	Lactiplantibacillus mudanjiangensis	Lactiplantibacillus
Lactobacillus nangangensis	Lactiplantibacillus nangangensis	Lactiplantibacillus
Lactobacillus paraplantarum	Lactiplantibacillus paraplantarum	Lactiplantibacillus
Lactobacillus pentosus	Lactiplantibacillus pentosus	Lactiplantibacillus
Lactobacillus pingfangensis	Lactiplantibacillus pingfangensis	Lactiplantibacillus
Lactobacillus plajomi	Lactiplantibacillus plajomi	Lactiplantibacillus
Lactobacillus plantarum subsp. plantarum	Lactiplantibacillus plantarum subsp. plantarum	Lactiplantibacillus
Lactobacillus songbeiensis	Lactiplantibacillus songbeiensis	Lactiplantibacillus
Lactobacillus xiangfangensis	Lactiplantibacillus xiangfangensis	Lactiplantibacillus
Lactobacillus argentoratensis	Lactiplantibacillus argentoratensis	Lactiplantibacillus
Lactobacillus curtus	Furfurilactobacillus curtus	Furfurilactobacillus
Lactobacillus rossiae	Furfurilactobacillus rossiae	Furfurilactobacillus
Lactobacillus siliginis	Furfurilactobacillus siliginis	Furfurilactobacillus
Lactobacillus hokkaidonensis	Paucilactobacillus hokkaidonensis	Paucilactobacillus
Lactobacillus kaifaensis	Paucilactobacillus kaifaensis	Paucilactobacillus
Lactobacillus nenjiangensis	Paucilactobacillus nenjiangensis	Paucilactobacillus
Lactobacillus oligofermentans	Paucilactobacillus oligofermentans	Paucilactobacillus
Lactobacillus suebicus	Paucilactobacillus suebicus	Paucilactobacillus
Lactobacillus vaccinostercus	Paucilactobacillus vaccinostercus	Paucilactobacillus
Lactobacillus wasatchensis	Paucilactobacillus wasatchensis	Paucilactobacillus
Lactobacillus alvi	Limosilactobacillus alvi	Limosilactobacillus
Lactobacillus antri	Limosilactobacillus antri	Limosilactobacillus
Lactobacillus caviae	Limosilactobacillus caviae	Limosilactobacillus
Lactobacillus coleohominis	Limosilactobacillus coleohominis	Limosilactobacillus
Lactobacillus equigenerosi	Limosilactobacillus equigenerosi	Limosilactobacillus
Lactobacillus fermentum	Limosilactobacillus fermentum	Limosilactobacillus
Lactobacillus frumenti	Limosilactobacillus frumenti	Limosilactobacillus
Lactobacillus gastricus	Limosilactobacillus gastricus	Limosilactobacillus
Lactobacillus gorillae	Limosilactobacillus gorillae	Limosilactobacillus
Lactobacillus ingluviei	Limosilactobacillus ingluviei	Limosilactobacillus
Lactobacillus mucosae	Limosilactobacillus mucosae	Limosilactobacillus
Lactobacillus not subsp. validly described	Limosilactobacillus not subsp. validly described	Limosilactobacillus
Lactobacillus oris	Limosilactobacillus oris	Limosilactobacillus
Lactobacillus panis	Limosilactobacillus panis	Limosilactobacillus
Lactobacillus pontis	Limosilactobacillus pontis	Limosilactobacillus
Lactobacillus reuteri	Limosilactobacillus reuteri	Limosilactobacillus
Lactobacillus secaliphilus	Limosilactobacillus secaliphilus	Limosilactobacillus
Lactobacillus vaginalis	Limosilactobacillus vaginalis	Limosilactobacillus
Lactobacillus collinoides	Secundilactobacillus collinoides	Secundilactobacillus
Lactobacillus kimchicus	Secundilactobacillus kimchicus	Secundilactobacillus
Lactobacillus malefermentans	Secundilactobacillus malefermentans	Secundilactobacillus
Lactobacillus mixtipabuli	Secundilactobacillus mixtipabuli	Secundilactobacillus
Lactobacillus odoratitofui	Secundilactobacillus odoratitofui	Secundilactobacillus
Lactobacillus oryzae	Secundilactobacillus oryzae	Secundilactobacillus
Lactobacillus paracollinoides	Secundilactobacillus paracollinoides	Secundilactobacillus
Lactobacillus pentosiphilus	Secundilactobacillus pentosiphilus	Secundilactobacillus
Lactobacillus silagei	Secundilactobacillus silagei	Secundilactobacillus
Lactobacillus silagincola	Secundilactobacillus silagincola	Secundilactobacillus
Lactobacillus similis	Secundilactobacillus similis	Secundilactobacillus
Lactobacillus acidifarinae	Levilactobacillus acidifarinae	Levilactobacillus
Lactobacillus angrenensis	Levilactobacillus angrenensis	Levilactobacillus
Lactobacillus bambusae	Levilactobacillus bambusae	Levilactobacillus
Lactobacillus brevis	Levilactobacillus brevis	Levilactobacillus
Lactobacillus cerevisiae	Levilactobacillus cerevisiae	Levilactobacillus
Lactobacillus fujinensis	Levilactobacillus fujinensis	Levilactobacillus
Lactobacillus fuyuanensis	Levilactobacillus fuyuanensis	Levilactobacillus
Lactobacillus hammesii	Levilactobacillus hammesii	Levilactobacillus
Lactobacillus huananensis	Levilactobacillus huananensis	Levilactobacillus
Lactobacillus koreensis	Levilactobacillus koreensis	Levilactobacillus
Lactobacillus lindianensis	Levilactobacillus lindianensis	Levilactobacillus
Lactobacillus mulengensis	Levilactobacillus mulengensis	Levilactobacillus
Lactobacillus namurensis	Levilactobacillus namurensis	Levilactobacillus
Lactobacillus parabrevis	Levilactobacillus parabrevis	Levilactobacillus
Lactobacillus paucivorans	Levilactobacillus paucivorans	Levilactobacillus
Lactobacillus senmaizukei	Levilactobacillus senmaizukei	Levilactobacillus
Lactobacillus spicheri	Levilactobacillus spicheri	Levilactobacillus
Lactobacillus suantsaii	Levilactobacillus suantsaii	Levilactobacillus
Lactobacillus suantsaiihabitans	Levilactobacillus suantsaiihabitans	Levilactobacillus
Lactobacillus tangyuanensis	Levilactobacillus tangyuanensis	Levilactobacillus
Lactobacillus tongjiangensis	Levilactobacillus tongjiangensis	Levilactobacillus
Lactobacillus yonginensis	Levilactobacillus yonginensis	Levilactobacillus
Lactobacillus zymae	Levilactobacillus zymae	Levilactobacillus
Lactobacillus enshiensis	Levilactobacillus enshiensis	Levilactobacillus
Lactobacillus florum	Fructilactobacillus florum	Fructilactobacillus
Lactobacillus fructivorans	Fructilactobacillus fructivorans	Fructilactobacillus
Lactobacillus ixorae	Fructilactobacillus ixorae	Fructilactobacillus
Lactobacillus lindneri	Fructilactobacillus lindneri	Fructilactobacillus
Lactobacillus sanfranciscensis	Fructilactobacillus sanfranciscensis	Fructilactobacillus
Lactobacillus vespulae	Fructilactobacillus vespulae	Fructilactobacillus
Lactobacillus jinshanensis	Acetilactobacillus jinshanensis	Acetilactobacillus
Lactobacillus buchneri subsp. buchneri	Lentilactobacillus buchneri subsp. buchneri	Lentilactobacillus
Lactobacillus buchneri subsp. silagei	Lentilactobacillus buchneri subsp. silagei	Lentilactobacillus
Lactobacillus curieae	Lentilactobacillus curieae	Lentilactobacillus
Lactobacillus diolivorans	Lentilactobacillus diolivorans	Lentilactobacillus
Lactobacillus farraginis	Lentilactobacillus farraginis	Lentilactobacillus
Lactobacillus hilgardii	Lentilactobacillus hilgardii	Lentilactobacillus
Lactobacillus kefiri	Lentilactobacillus kefiri	Lentilactobacillus
Lactobacillus kisonensis	Lentilactobacillus kisonensis	Lentilactobacillus
Lactobacillus otakiensis	Lentilactobacillus otakiensis	Lentilactobacillus
Lactobacillus parabuchneri	Lentilactobacillus parabuchneri	Lentilactobacillus
Lactobacillus parafarraginis	Lentilactobacillus parafarraginis	Lentilactobacillus
Lactobacillus parakefiri	Lentilactobacillus parakefiri	Lentilactobacillus
Lactobacillus raoultii	Lentilactobacillus raoultii	Lentilactobacillus
Lactobacillus rapi	Lentilactobacillus rapi	Lentilactobacillus
Lactobacillus sunkii	Lentilactobacillus sunkii	Lentilactobacillus
Lactobacillus senioris	Lentilactobacillus senioris	Lentilactobacillus
Lactobacillus plantarum subsp. argentoratensis	Lactiplantibacillus argentoratensis	 Lactiplantibacillus
Lactobacillus buchneri	Lentilactobacillus buchneri subsp. buchneri	Lentilactobacillus
Lactobacillus aviarius subsp. aviarius	Ligilactobacillus aviarius	Ligilactobacillus
Lactobacillus aviarius subsp. araffinosus	Ligilactobacillus araffinosus	Ligilactobacillus
Lactobacillus homohiochii	Fructilactobacillus fructivorans	Fructilactobacillus
Lactobacillus kosoi	Apilactobacillus kosoi	Apilactobacillus
Lactobacillus renini	Loigolactobacillus rennini	Loigolactobacillus
Lactobacillus plantarum	Lactiplantibacillus plantarum subsp. plantarum	Lactiplantibacillus
Lactobacillus delbrueckii	Lactobacillus delbrueckii subsp. delbrueckii	Lactobacillus
Lactobacillus kefiranofaciens	Lactobacillus kefiranofaciens subsp. kefiranofaciens	Lactobacillus
Lactobacillus paracasei	Lacticaseibacillus paracasei subsp. paracasei	Lacticaseibacillus
Lactobacillus sakei	Latilactobacillus sakei subsp. carnosus	Latilactobacillus
Lactobacillus coryniformis	Loigolactobacillus coryniformis subsp. coryniformis	Loigolactobacillus
